34 16
1 1 1 1 1 1 1 1 1 1 1 1 1 1 1 1 1 1 1 1 1 1 1 1 1 1 1 1 1 1 1 1 1 1
1 1 1 1 1 1 1 1 1 1 1 1 1 1 1 1 1 1 1 1 1 1 1 1 1 1 1 1 1 1 1 1 1 1
1 1 1 1 1 1 1 1 1 1 1 1 1 1 1 1 1 1 1 1 1 1 1 1 1 1 1 1 1 1 1 1 1 1
1 1 1 1 1 1 1 1 1 1 1 1 1 1 1 5 5 5 1 1 1 1 1 1 1 5 5 5 1 1 1 1 1 1
1 1 1 1 1 1 1 1 1 1 1 1 1 1 0 5 8 8 5 5 1 1 1 5 5 8 8 5 1 1 1 1 1 1
1 1 1 1 0 0 1 1 1 0 1 1 1 0 1 5 8 8 8 5 5 5 5 5 8 8 8 5 1 1 1 1 1 1
1 0 0 0 5 5 0 1 0 5 0 1 0 1 1 5 5 8 5 5 2 2 2 5 5 8 5 5 1 1 1 1 1 1
0 5 5 0 5 5 0 0 5 5 0 0 1 1 1 1 5 5 5 8 8 2 8 8 5 5 1 1 1 1 1 1 1 1
0 5 5 0 5 0 1 0 5 5 0 1 1 1 1 1 6 5 2 2 9 2 10 2 2 5 7 1 1 1 1 1 1 1
1 0 5 0 0 0 0 0 5 0 1 1 1 1 1 1 5 2 2 2 2 2 2 2 2 2 5 1 1 1 1 1 1 1
1 1 0 2 2 2 2 0 0 1 1 1 1 1 1 1 5 2 2 5 5 5 5 5 2 2 5 1 1 1 1 1 1 1
1 0 2 5 5 5 2 2 2 0 1 1 1 1 1 1 5 2 2 5 8 8 8 5 2 2 5 1 1 1 1 1 1 1
0 2 5 5 5 5 5 5 2 0 1 1 1 1 1 1 4 5 8 5 8 0 8 5 8 5 3 1 1 1 1 1 1 1
0 2 5 5 5 5 5 2 0 1 1 1 1 1 1 1 1 4 5 8 5 5 5 8 5 3 1 1 1 1 1 1 1 1
0 2 2 2 2 2 2 0 1 1 1 1 1 1 1 1 1 1 1 5 8 8 8 5 1 1 1 1 1 1 1 1 1 1
0 0 0 0 0 0 0 1 1 1 1 1 1 1 1 1 1 1 1 1 5 5 5 1 1 1 1 1 1 1 1 1 1 1