41 24
1 1 1 1 1 1 1 1 1 1 1 1 1 1 1 1 1 1 1 1 1 1 1 1 1 1 1 1 1 1 1 1 1 1 1 1 1 1 1 1 1
1 1 1 1 1 1 1 1 1 1 1 1 1 1 1 1 1 1 1 1 1 1 1 1 1 1 1 1 1 1 1 1 1 1 1 1 1 1 1 1 1
1 1 1 1 1 1 1 1 1 1 1 1 1 1 1 1 1 1 1 1 1 1 1 1 1 1 1 1 1 1 1 1 1 1 1 1 1 1 1 1 1
1 1 1 1 1 1 1 1 1 1 1 1 1 1 1 1 1 1 1 1 1 1 1 1 1 1 1 1 1 1 1 1 1 1 1 1 1 1 1 1 1
1 1 1 1 1 1 1 1 1 1 1 1 1 1 1 1 1 1 1 1 1 1 1 1 1 1 1 1 1 1 1 1 1 1 1 1 1 1 1 1 1
1 1 1 1 1 1 1 1 1 1 1 1 1 1 1 1 1 1 1 1 1 1 1 1 1 1 1 1 1 1 1 1 1 1 1 1 1 1 1 1 1
1 1 1 1 1 1 1 1 1 1 1 1 1 1 1 1 1 1 1 1 1 1 1 1 1 1 1 1 1 1 1 1 1 1 1 1 1 1 1 1 1
1 1 1 1 1 1 1 1 1 1 1 1 1 1 1 1 1 1 1 1 1 1 1 1 1 1 1 1 1 1 1 1 1 1 1 1 1 1 1 1 1
1 1 1 1 1 1 1 1 1 1 1 1 1 1 1 1 1 1 1 1 1 1 1 1 1 1 1 1 1 1 1 1 1 1 1 1 1 1 1 1 1
1 1 1 1 1 1 1 1 1 1 1 1 1 1 1 1 1 1 0 0 0 1 1 1 1 1 1 1 0 0 0 1 1 1 1 1 1 1 1 1 1
1 1 1 1 1 1 1 1 1 1 1 1 1 1 1 1 1 1 0 8 8 0 0 1 1 1 0 0 8 8 0 1 1 1 1 1 1 1 1 1 1
1 1 1 1 1 1 1 0 0 1 1 1 0 1 1 1 1 1 0 8 8 8 0 0 0 0 0 8 8 8 0 1 1 1 1 1 1 1 1 1 1
1 1 1 1 0 0 0 5 5 0 1 0 5 0 1 1 1 1 0 0 8 0 0 2 2 2 0 0 8 0 0 1 1 1 1 1 1 1 1 1 1
1 1 1 0 5 5 0 5 5 0 0 5 5 0 0 1 1 1 1 0 0 0 8 8 2 8 8 0 0 1 1 1 1 1 1 1 1 1 1 1 1
1 1 1 0 5 5 0 5 0 1 0 5 5 0 1 1 1 1 1 6 0 2 2 9 2 10 2 2 0 7 1 1 1 1 1 1 1 1 1 1 1
1 1 1 1 0 5 0 0 0 0 0 5 0 1 1 1 1 1 1 0 2 2 2 2 2 2 2 2 2 0 1 1 1 1 1 1 1 1 1 1 1
1 1 1 1 1 0 2 2 2 2 0 0 1 1 1 1 1 1 1 0 2 2 0 0 0 0 0 2 2 0 1 1 1 1 1 1 1 1 1 1 1
1 1 1 1 0 2 5 5 5 2 2 2 0 1 1 1 1 1 1 0 2 2 0 8 8 8 0 2 2 0 1 1 1 1 1 1 1 1 1 1 1
1 1 1 0 2 5 5 5 5 5 5 2 0 1 1 1 1 1 1 0 0 8 0 8 0 8 0 8 0 0 1 1 1 1 1 1 1 1 1 1 1
1 1 1 0 2 5 5 5 5 5 2 0 1 1 1 1 1 1 1 4 4 0 8 0 0 0 8 0 3 3 1 1 1 1 1 1 1 1 1 1 1
1 1 1 0 2 2 2 2 2 2 0 1 1 1 1 1 1 1 1 1 1 4 0 8 8 8 0 3 1 1 1 1 1 1 1 1 1 1 1 1 1
1 1 1 0 0 0 0 0 0 0 1 1 1 1 1 1 1 1 1 1 1 1 4 0 0 0 3 1 1 1 1 1 1 1 1 1 1 1 1 1 1
1 1 1 1 1 1 1 1 1 1 1 1 1 1 1 1 1 1 1 1 1 1 1 1 1 1 1 1 1 1 1 1 1 1 1 1 1 1 1 1 1
1 1 1 1 1 1 1 1 1 1 1 1 1 1 1 1 1 1 1 1 1 1 1 1 1 1 1 1 1 1 1 1 1 1 1 1 1 1 1 1 1