34 16
14 15 15 15 14 15 15 15 15 9 9 15 15 9 9 15 15 15 15 15 15 15 15 15 14 14 15 15 9 9 15 15 9 9
15 15 14 15 14 14 14 15 9 15 15 15 15 15 15 15 9 15 15 9 15 15 15 15 15 9 15 9 9 15 15 15 15 15
14 15 9 14 14 14 14 15 15 14 14 15 15 15 15 9 15 9 15 9 9 9 15 15 15 15 15 15 15 15 15 15 15 15
9 9 14 15 15 15 9 9 14 9 15 15 15 15 15 15 14 15 14 15 9 15 15 15 15 15 15 15 15 15 15 15 15 15
9 9 15 15 9 9 15 14 14 15 15 15 15 15 15 15 15 15 9 15 15 9 15 15 15 15 15 15 9 15 9 9 9 15
14 14 15 9 14 14 14 15 14 15 15 15 15 15 15 15 15 14 15 14 9 15 15 15 15 15 15 15 9 15 15 15 9 9
9 15 15 14 15 14 15 15 15 15 15 14 15 14 9 15 15 15 14 9 9 15 15 15 15 9 15 15 9 15 15 15 9 15
15 15 9 14 14 14 15 15 15 15 15 15 15 15 15 16 14 15 15 9 9 9 9 15 9 15 15 15 9 9 9 9 15 15
9 15 14 16 16 16 16 15 16 15 16 16 16 16 16 14 9 15 9 9 15 9 9 15 15 15 15 15 9 9 15 15 15 15
9 15 15 14 14 14 15 15 14 15 14 15 15 15 9 9 15 15 9 9 9 9 9 15 9 9 9 9 9 15 15 9 15 15
14 14 16 16 16 16 16 16 14 15 15 15 15 9 9 9 15 9 9 9 9 15 15 9 9 9 9 9 9 9 9 15 15 15
9 16 16 16 16 16 16 16 9 9 14 15 9 15 15 15 9 9 9 9 15 9 15 9 9 9 9 9 9 9 9 15 15 15
9 9 16 16 16 16 16 15 15 15 15 15 15 9 9 9 9 9 15 15 15 15 15 9 9 9 9 9 9 9 15 15 9 9
14 9 9 16 16 16 9 9 14 15 14 14 9 9 9 9 9 9 15 15 9 15 15 9 9 9 9 9 9 15 15 15 15 15
9 9 9 9 16 15 9 14 14 14 14 9 14 14 14 9 15 9 15 15 15 15 15 15 15 9 15 15 9 15 15 9 15 15
9 9 9 14 14 14 14 14 14 15 14 14 14 9 9 9 15 9 9 9 9 15 15 15 9 15 15 9 9 9 9 15 15 15