17 13
1 1 1 1 1 1 1 1 1 1 1 1 1 1 1 1 1
1 3 1 1 1 1 1 1 1 1 1 1 1 1 1 1 1
1 1 1 1 1 1 1 1 1 1 1 1 1 1 1 1 1
1 1 1 1 1 1 1 1 1 1 8 8 8 1 1 1 1
1 1 1 1 1 1 1 1 1 8 8 8 8 8 1 1 1
1 1 1 1 1 1 1 1 1 8 8 8 8 8 1 1 1
1 1 1 1 1 1 1 1 1 1 8 8 8 1 1 1 1
1 1 1 1 1 1 1 1 1 1 1 12 1 1 1 1 1

1 1 1 1 1 1 1 1 1 10 1 13 1 10 1 1 1
1 1 1 1 7 0 7 0 7 0 7 0 7 0 1 1 1
1 1 1 1 1 16 16 16 16 16 16 16 16 1 1 1 1
1 1 1 1 1 1 1 1 1 1 1 1 1 1 1 1 1
1 1 1 1 1 1 1 1 1 1 1 1 1 1 1 1 1

1 1 1 1 1 1 1 1 1 9 1 13 1 10 1 1 1
14 14 14 14 7 0 7 0 7 0 7 0 7 0 14 14 14
15 15 15 15 15 16 16 16 16 16 16 16 16 15 15 15 15
15 15 15 15 15 15 15 15 15 15 15 15 15 15 15 15 15
15 15 15 15 15 15 15 15 15 15 15 15 15 15 15 15 15

